..............#.#...
.#...#...#.##..##.#.
..###.###.#...#...#.
......#...#.#.#.#.#.
..##.##.#.#.#.#.#.#.
.#.#..#.#.#B#.#.#.#.
.#..#.#.#.#.#.#.#.#.
.#.#..#.#.#.#.#.#.#.
......#.#.##..#.#...
..#####.#.#.#...#...
........#.#.####..#.
..#######.#.#.......
....#...#...##.#####
...#..#..###........
...#..#.#...#######.
...#..#.#.#.#.......
..#...#.#.#.#.######
.#....#.#.#.#.......
......#.#.#.#######.
A.........#.........
