............##......
............##......
............##......
............##......
....####....##......
....####....##......
....####....##.....B
....####....##......
....####....##..####
....####....##..####
....####....##..####
....####....##..####
....####....##......
....####....##......
....####....##......
....####....##......
....####............
....####............
....####............
A...####............
