_________B
________##
__#####___
__#####___
__#####___
__#####___
__#####___
__________
__________
A_________
