.........B
........##
..#####...
..#####...
..#####...
..#####...
..#####...
..........
..........
A.........
