....................
..B.................
....................
....................
....................
.....##########.....
.....##########.....
.....##########.....
.....##########.....
.....##########.....
.....##########.....
.....##########.....
.....##########.....
.....##########.....
.....##########.....
....................
...................A
.####...............
....................
....................