...................B
....................
...##########..###..
...##########..###..
...............###..
....................
....................
....................
....................
....................
.................##.
.............#####..
.............#####..
.............#####..
....................
..............#####.
..............#####.
....................
....................
....................
A...................