...#...#...#.....#B.
.#...#...#...#..#.#.
..###.###.###.##..#.
......#...#...#..#..
..##.##.#.#.#.#..#..
.#.#..#.#.#.#.#.#..#
.#..#.#.#.#.#.#.#.#.
.#.#..#.#.#.#.#.#.#.
......#.#.#.#.#.#...
..#####.#.#.#...##..
........#.#.####..#.
..#######.#.#.......
....#...#...#.######
...#..#..###........
...#..#.#...#######.
...#..#.#.#.#.......
..#...#.#.#.#.######
.#....#.#.#.#.......
......#.#.#.#######.
A.....#...#.........
