...#...#...#.....#B.
.#...#...#...#.##.#.
..###.###.#.#.#...#.
......#...#...#.#.#.
..##.##.#.#.#.#.#.#.
.#.#..#.#.#.#.#.#.#.
.#..#.#.#.#.#.#.#.#.
.#.#..#.#.#.#.#.#.#.
......#.#.#...#.#...
..#####.#.#.#...#...
........#.#.####..#.
..#######.#.#.......
....#...#...##.#####
...#..#..###........
...#..#.#...#######.
...#..#.#.#.#.......
..#...#.#.#.#.######
.#....#.#.#.#.......
......#.#.#.#######.
A.........#.........
