...................B
...................#
...###############..
...########....###..
...............###..
...............##..#
...............##.#.
................#.#.
................#...
................##..
..................#.
.............###.#..
.............#...#..
.............#####..
....................
..............#####.
..............#####.
....................
....................
A...................
