..........
.....##...
.....##...
..##.##...
..##.##..B
..##......
..##.####.
..##.####.
..##.####.
A.##.####.
