......##..
......##..
......##..
...##.##..
...##....B
...##.....
...##.####
...##.####
...##.####
A..##.####
