__________
_____##___
_____##___
__##_##___
__##_##__B
__##______
__##_####_
__##_####_
__##_####_
A_##_####_
