.............B......
....................
....................
....................
............##......
....####....##......
....####....##......
....####....##......
....####....##......
....####....##..####
....####....##..####
....####....##..####
....####....##..####
....####....##......
....####....##......
....####....##......
....####....##......
....####............
....####............
....####............
A...####............